#########
#T111111#
#######1#
#1111111#
#1#######
#111111B#
#########