####################################################################################################
#82724347447949974437274846616546912365768722845343387918786154467376997181873278931519678964315959#
#37992555923911859239845259425286264362589959833131741217946344867586873842271372122939481294188785#
#72112146522438255349144492475425749946619444433985819364255975818917754388287184646893929411937167#
#18463325136163254391839674848622158619899292465147355668366429666169351249161739519261889336124682#
#27661472445783731779314999229517874364473919591438838952998814894214439976879249242923294785162231#
#85348125732928797344963125936164177595988892222113129299424872979464479879944268665252534351132389#
#31643828566674512884339675716226424955785289578369792944577294183733819378723297889275444332233595#
#48755727921362231638178887882984485733425929686682724919883837395111561739638915413987542484792916#
#45517432973921112934831974558653133199835154451424626759482117647852258958955133167846885236743916#
#95739699669745518779364441762682541794151326572693739768211544744733565912596713923956699922159133#
#73433535342931897864698235843519239255734467364662235371976676749152556564394791333388832738222184#
#56213717315191782692867949253211762176528879977756532163845181585926663676624521364544932372621369#
#69731142471572931549546179631627633396446773967372225144134832891744939834783183621865746751939627#
#45978125978563716639558684465763117341786481956766511297486319521126229916325247593369624185499413#
#29965914172994928157623313411997863441762534637183586674745685456758755768357747459492237176635529#
#58577919794642828897728451443611131975818377883375872489537139987714532831481881293531241292882152#
#93322414535995128775648611666464856668995487163837451246263829499558914217986496556291886669597167#
#776927771T1938892815439378693742271776222192874331532166783649567829684961222784576615416621891261#
#63795222959658598185767556986224161885867927498584367731761281823596914621616765539535486812953544#
#34838356238299117924146322348182615545815862753319275922238739829282122192793918738354885933534118#
#55464485619687887126149463762525336225384626971612322983759763257559497216125675416846423845552218#
#75217512258938885642897297774879586774984415295889965539578434549699893378542464946769875294145981#
#42611762853387636533674763919625328924837478478722828598361791639763826575538634974219799825441528#
#88996513645891259243494759124227812548847265164384326977578611397516441198864724564327398697953795#
#42756116957792672926213755823375615218263749528681997749942341911918296868994617163986368583363697#
#76982918994623478518737972983971737482261714978789945676246492536393496811136154451452651523768749#
#97275916457818933251541437722724447523468912786951183952415421987727558847278346112726481582997672#
#31628711829849192961797588491662414282915615536554656636114924911333891776351936445349247877736848#
#54312821164389536912535141687599464315597613281746698927256263296536676559674971993557792687528515#
#85897512818181258792426571422334649931434145993918432911237588461284755678665185462842771824392151#
#28517458354191728363631141469313117275351514942412457871579723212898975175964373655333424727711574#
#55684955158791778256755898988494468831473315841151177843842359247629557442114767274661386344626864#
#48518242375163795912841764115877742198239387371959484626826659689964156493642383471543611637664533#
#35185751152976162764328784283571947165717881343411155565895639115764195219149538996785116254518566#
#32222855366287817662742773946469852262929967541579623155281617578249929916286782761656177728242844#
#18837712614356974787285125713341173392996158898542767252322899659757771149869622244874884313451573#
#92784395593547945424695777748782744891193952737786435987643117367181372765486968217553593353333258#
#67742949843956569162723159966245254643425263547169657518457511327929593187411511144935798992687431#
#56725543111117564122143664227958818424787435678429542131244166668125193419734496687311535248985193#
#1814442379154872688191855954162799121169955993166878B784629584283479232533287639869368284246828835#
#11875172122915423145821637368819298253947562587442947315434524955453115665668697783536149863822842#
#48717583844431911194384219754395121553665478854533441145398357998911592512576552221746519469728947#
#48468312952841327632192379937153122528145623196885684925783484335992559577324293839191743886347598#
#64567471738173172179177121461447638367295223443624863731346762292732493942167915529742736777275735#
#66888844623529281717493779935967544533947556192553591999912279264611715395113832217616811414673582#
#66623149441442744875615973789128476657496999637268975115145812323689158891194275169141471367881354#
#43396649887363495325335773912289536593373721413985245619146598998573981182299544855151854763576283#
#12514381335694499766587453517116666211413226954679621932465688522953821339892487964249845428269759#
#27138553645468821235426393378428162976197531957792229829256129229954443766651286527784556745457728#
#19155369144345273174778378392613912376447399194315532411175116869387931639642389272936183871281774#
#13719361344949272579572896796825797344177522571582861517626483898997351615351712332443446245541776#
#14815755722112998287638852126689631174292757352884421874886826322131214131379896273591467843916193#
#71785352668323915165895425259155247628499418162156595884326173711444339179767153859452693456993881#
#86691498122453685729787731835185129723342155198531991212924864961951335832228526351915572952534789#
#91239797521259744391888872211735599292229787718859184876226448787475324373578433717153389777522228#
#45891744974533227952232357422132982227257223943663265295426399295423638495989916151815116666137711#
#55189298659493978331521996926426887554958889411294746821723926464925975563145435743663254659367791#
#22217543731557334833211374273541534864986579689436283661482715471922199125992385469471256427398829#
#41916588116818599782225134347475977184492899793636511249583239622516795442697421869724268669746459#
#81166984291239756173424484752446642623965348529651746783996855161574529324727289429514966524712333#
#88332782737598144391877911252653942157484786592174518519729968368933467694597616964813697166376123#
#87294642269133318182183627714341338482288824141247176746646876444981343683177462218418552885275443#
#67288417335952955776726578525598536566536225777626246411223111517528465618187352466578642823818442#
#28861414444584451518683759386513898259544524626417925914231752526992312156578624367536341162684219#
#21297467656558134716662859883829245337917658956666548618398584892617281644852285714661226574999221#
#12395416837666476734198281245461961654371921319634562331246852495522597794377524355565458244725322#
#43124621246298712148949167223996892695425616619869669241826664791955483311664896165526218816615743#
#17999824445128734396979859659228841215635424422129968198315641832461157938231753533651669156386794#
#14335668652621419852229956868864619266566187591792393652642237897127638217288771721664979584688837#
#91712481231839585223369234873484428289922485781866571671132993114354482179486264534465823694963423#
#85575941712261843654413437914771366369517583537265823168454927168441694767696482379775586686113276#
#56327962618628962632363158911939212568152233381641521181396349227218585643165128144788544318223819#
#44658328685244247867138554466895535346211161219117616252226145163526237742672182966885639586933636#
#83332532134255692443856181985513433265777146246745865671968132388234897678547921563977549933619687#
#52853122758916832956851554651191647183831774392558752697946491764798783553489798945741988511811684#
#32135911579583366189595511483837483925295188748497268581127239278287427761952688131595376884622373#
#36194296794112988863759726662433371915917123214564299366528568671226882881922416373727779678559728#
#29725588559659759358556174574289193483627883992496167994263562937816974894726333998548522633833853#
#14539688152675849352975544615131455147991737785184297691739158664374194592756858454649699443933878#
#83552462824331192223492924485154677871944253696286341713343499691421951889639753871899477575988296#
#38137337265657533461678713433956968676732342628322116161881422248938681629759312846545725795497889#
#91534346442798415846571927951131198422397445796875171973716968295779862477513917273974999715176443#
#12213851978472994273231981522557517975341681153731979621686711775868638621852631127488327453692839#
#51835222149663894696651426253548923857165324362997959578111992639264286682168362914491628747836159#
#14121125484855572264983354644486458725653484151539862214625264648874415686729476236924164823395291#
#29892556238225564829199372478292561596618144951289267161387331627854561763552785976924378915997544#
#68374445984813698328678649655747167139391496261354479343362769216789525517221346118284662395145465#
#61118127464188759347473346535679914688827631175842227412968158458843267114387983859216441619283386#
#48447211296635136863234438939982393475825386489782342148874334642146346654919536492243844654344656#
#31428419368866351472735858754793958881399455735464649775493651193412812588966753148892787789111265#
#21642645188826144462771248167728324826968644357854172281614387698867188296292963789262223185524128#
#48219643169275634252186594442288726241168936497869777421912221177322862426135256245751711614217339#
#67546913617393549131124632954458652213574739281371734622359668338699546692328719393698887771914614#
#62467527578277153621819143761628981196865982611584422246287733179547734714634287896557872432316916#
#23513651143332919196656726447735669948929333392141244567785539875761742943945755964695473498624427#
#96315234546851782975646994121817294366485512759581424261337261758458521248853867446438715783819394#
#65553432535624871778416413344576715282613894589695222625816721153362127384327516912282842449495474#
#27739614136559655988754354589568324354364523612997353189898637682813166941834449998573965754916285#
####################################################################################################